1

   11111                                               
   10001     1
   10N01   1            
   10001
   11111    1    


