
1111111
1000101
10N0111
10001
11111
