11111
1000N
10001
10001
11111
