F 0,0,0
C 0,0,0

NO ./textures/tronlined0_128.xpm
EA ./textures/tronlined1_128.xpm
SO ./textures/tronlined2_128.xpm
WE ./textures/tronlined3_128.xpm

11111
100011111
10N0001
100011
11111