11111
10001
100N1
10001         1
11111
