NO ./textures/dirt_n.xpm
EA ./textures/dirt_e.xpm
SO ./textures/dirt_s.xpm
WE ./textures/dirt_w.xpm

C 20,20,80
F 20,80,2


11111
10001
10N01
10001
11111
