F 0,0,10
C 0,0,10

NO ./textures/full1_256.xpm
EA ./textures/full3_256.xpm
SO ./textures/full0_256.xpm
WE ./textures/full3_256.xpm

111111111
100000001
100000001
100000001
100000001
100000001
100000001
100000001     111
111101111     101
  100011111111101
  110110101010101
  100000000000001
  110110101010101
  100011111111111
  11011
  11011
  10001
  11011
  11011
  11011
  10001
  11011
  11011
  11011
  11N11
  11111