11111
10001
10N01
10001
1111b
