

  11111
  10001
  10001
1110111
10001
100011111111
100000000001
10W011111111
11111


