F                 88,12,q

WE ./textures/tile13.xpm
C 255,3,2


NO ./textures/tile10.xpm 

SO ./textures/tile12.xpm
EA ./textures/tile11.xpm

  111111
  10001
  11101
    101
    101
111110111111
1000000000W1
101110111111
101110100001
101000000001
101010100001
101110100011
101110100001
111000100001
111111111111
