

    111
    1N1
    111

      111
      1111111111
      111

