11111
10W01
1S001
10001
11111
