NO ./textures/tronlined0_128.xpm
EA ./textures/tronlined1_128.xpm
SO ./textures/tronlined2_128.xpm
WE ./textures/tronlined3_128.xpm
F 0,255,0
	  z C 0,0,0

11111
10001
10N01
10001
11111