F 0,0,0
C 0,0,0

NO ./textures/tronlined0_128.xpm
EA ./textures/tronlined1_128.xpm
SO ./textures/tronlined2_128.xpm

C 255,0,0
WE ./textures/tronlined3_128.xpm

11111
10001
10N01
10001
11111